1111111111111111111111111
10000C00C0000C10000C00001
10000C100000011C110010001
1010010010100000000010011
1P1000001000C0000C00C00E1
1111111111111111111111111