111111111111111111111111111111
10000C00C000000000N00000C00001
10N001000N00010000N1C110010001
1010010000011N00000N0C0011NN01
10000C00C00C1000C00N0000N00001
10000C00C0000NC000000000C00001
10N000000N000110000NC110010001
1010010000011N000000NC0011N001
1P1NNN001000C0NN0000N0000C00E1
111111111111111111111111111111