1111111111111111111111111
1P000000111000C0000000001
1011111110100011001101011
101000C000100001100C00001
1000000000000000100000001
1001C00011000001111100001
101000000000011C000000001
10111111100010010000000E1
1111111111111111111111111