11111111
1N0CE0P1
10CC0001
11111111