1111111111111111111111111
10000C00C0010000000C00001
10100C000100011C110010001
10C00100100000000000000C1
1P10C0001000C0000C00000E1
1111111111111111111111111