111111111111111111111111111111111
1000C000000000000000C000000N00001
10N0000N000C00C000C00C00000000001
10000C0C00000000N000000C00CN00001
10000000000000000000000000C000001
1000C00000C0N00000C00000000N00C01
100N0000000000C0000NC00000000N001
100000C00000C000000000C0000C00001
10N000C00N00000000000N0000N000001
1000000C000000C0000000C0000N00001
10000000000N0000000N00C000C000001
100C000C00000000C0000CC0000000001
1000C0N00000C00000N0000000C000001
10C00000N00000000N0C00000E000000
1000P0C0C000C0000000000C0C0000001
100000000000000000000000000000001
111111111111111111111111111111111