1111111111111111111111111
10000C00C0000000000C00001
10000C000000011C110010001
1010010011111000000111111
1P1000001000C0000C00000E1
1111111111111111111111111